
NO textures/walls/ceil_block.png
SO textures/walls/bluestone.png
WE textures/walls/eagle.png
EA "textures/walls/colorstone.png"

F 42, 42      ,42
C 0,0,  139


11111111111111111111111111111111111111111111111111111111111111111111111111111111111
10100000100000000000000000000000000000000000000000000000000000000000000000000000001
10101010101111111010101010101010101010101010101010101010101010101010101010101010101
10001010001000001010001010101010101010101010101010101010101010101010101010101010101
11111010111110101110101010101010101010101010101010101010101010101010101010101010101
10000010100010100000100010101010101010101010101010101010101010101010101010101010101
10110110101110111111111010101010101010101010101010101010101010101010101010101010101
10100000101010000010101010101010101010101010101010101010101010101010101010101010101
10101111101011111010101010101010101010101010101010101010101010101010101010101010101
10101000101010001010101010101010101010101010101010101010101010101010101010101010101
101110101010101010101110101010101010101N1010101010101010101010101010101010101010101
10000010101000101000100010101010101010101010101010101010101010101010101010101010101
11111110101111101110101010101010101010101010101010101010101010101010101010101010101
10000010100010001000101010101010101010101010101010101010101010101010101010101010101
10111010111010111011101010101010101010101010101010101010101010101010101010101010101
10110010000010001010101010101010101010101010101010101010101010101010101010101010101
10101111101111101010101010101010101010101010101010101010101010101010101010101010101
10101010000000001010101010101010101010101010101010101010101010101010101010101010101
10111111111111111111101010101010101010101010101010101010101010101010101010101010101
10101010101000000000101010101010101010101010101010101010101010101010101010101010101
11111111111111111111111111111111111111111111111111111111111111111111111111111111111

