NO                     textures/walls/ceil_block.png
SO

            textures/walls/bluestone.png
WE
textures/walls/eagle.png

F   190, 100, 23



EA textures/walls/colorstone.png

C 30, 198,

250

1111111111111111111111111111111
1000000000000000000000000000001
1000000000010000000000000000001
1000000100000000000000011111111
1000000001010000000000000000001
1000000100000000000000000000001
1000000000000000000000000000001
1000000000000000000010000000001
1000000000000000000000000000001
1000000000000000000000000000001
1000000000000000000000000000001
1000000000000000000000000000001
1000000000000000000000000000001
1000000000000000000000000000001
10000000000000N0000010000000001
1000000000000000000010000000001
1000000000000000000010000000001
1000000000000000000010000000001
1111111111111111111111111111111