
NO textures/walls/bluestone.png
SO textures/walls/ceil_block.png
WE textures/walls/colorstone.png
EA textures/walls/colorstone.png

F 42, 42 ,42  j fsjsjkldljkf;jfs
""
C 0,0,  139

111111111111111111111
101000001000000000001
101010101011111110001
100010100010000010001
111110101111101011101
100000101000101000001
101101101011101111111
101000001010100000101
101011111010111110101
101010001010100010101
101110101010101010101
100000101010001010001
111111101011111011101
100000101000100010001
101110101110101110111
101100100000100010101
101011111011111010101
101010100N00000010001
101111111111111111101
101010101010000000001
111111111111111111111
