NO textures/walls/ceil_block.png
SO textures/walls/bluestone.png
WE textures/walls/eagle.png
EA textures/walls/colorstone.png

F 0,128,0
C 135,206,250

111111111111
1         11
1          1
111111011111
1000000N0001
100000001111
11         1
111111111111